"university","women_22","men_22","all_students_22","women_21","men_21","all_students_21","delta_22","delta_21","mean_age_w_22","mean_age_m_22","mean_age_w_21","mean_age_m_21"
"Національний університет ""Львівська політехніка""",1736,4613,6349,1216,1609,2825,187,-15,18,25,18,19
"Західноукраїнський національний університет",848,3807,4655,805,922,1727,313,-6,20,29,20,22
"Чернівецький національний університет ім. Ю. Федьковича",1111,2511,3622,783,740,1523,239,-13,19,25,18,19
"Прикарпатський національний університет ім. В. Стефаника",1442,2022,3464,1228,693,1921,192,15,19,25,18,18
"Львівський національний університет ім. І. Франка",1888,1572,3460,2008,1217,3225,29,8,18,22,18,19
"Державний вищий навчальний заклад ""Ужгородський національний університет""",1149,2275,3424,803,875,1678,160,2,19,26,18,19
"Київський національний університет ім. Т. Шевченка",1697,1599,3296,2157,1784,3941,-10,1,19,21,19,19
"Запорізький національний університет",846,2349,3195,802,687,1489,242,-27,20,29,18,20
"Державний торговельно-економічний університет",1450,1563,3013,1511,1314,2825,19,-10,18,20,18,18
"Національний університет ""Запорізька політехніка""",335,2593,2928,437,601,1038,331,12,24,31,18,19
"Національний університет біоресурсів і природокористування України",790,2022,2812,833,1056,1889,91,-10,20,25,18,18
"Луцький національний технічний університет",519,2032,2551,205,375,580,442,1,19,25,18,19
"""Європейський університет""",348,2172,2520,282,593,875,266,125,20,28,18,20
"Національний технічний університет ""Дніпровська політехніка""",426,2066,2492,441,692,1133,199,1,19,26,18,19
"Національний авіаційний університет",1009,1479,2488,1275,1565,2840,-5,2,19,21,18,19
"Київський національний економічний університет ім. В. Гетьмана",1138,1136,2274,1149,1050,2199,8,0,18,20,18,18
"Національний університет ""Одеська юридична академія""",1138,1094,2232,1431,903,2334,21,-17,18,22,18,18
"Волинський національний університет ім. Лесі Українки",1057,1159,2216,771,446,1217,160,11,20,26,19,19
"Івано-Франківський національний технічний університет нафти і газу",206,1980,2186,167,391,558,406,-33,19,28,18,18
"Державний університет телекомунікацій",305,1750,2055,301,999,1300,75,15,21,23,20,19
"Національний технічний університет ""Харківський політехнічний інститут""",202,1821,2023,417,1068,1485,71,15,23,29,19,20
"Сумський національний аграрний університет",280,1606,1886,153,332,485,384,-13,22,29,22,22
"""Київський університет культури""",807,1040,1847,678,389,1067,167,-33,19,25,18,19
"Державний університет ""Житомирська політехніка""",536,1299,1835,399,565,964,130,9,19,24,18,19
"Національний технічний університет України «Київський політехнічний інститут ім. Ігоря Сікорського»",585,1200,1785,683,1177,1860,2,-4,19,21,18,19
"Харківський національний університет ім. В. Каразіна",728,1055,1783,1814,1344,3158,-22,0,20,26,18,19
"Хмельницький національний університет",494,1253,1747,405,544,949,130,-13,19,23,19,19
"ПрАТ ""Вищий навчальний заклад ""Міжрегіональна Академія управління персоналом""",350,1314,1664,244,319,563,312,5,19,30,19,21
"Національний університет ""Полтавська політехніка ім. Ю. Кондратюка""",494,1105,1599,268,536,804,106,0,19,23,19,20
"Львівський національний університет природокористування",129,1467,1596,54,205,259,616,-26,19,25,19,19
"Міжнародний гуманітарний університет",770,747,1517,778,346,1124,116,-17,20,25,19,19
"Полтавський державний аграрний університет",312,1199,1511,179,338,517,255,-40,20,26,19,20
"Національний університет водного господарства та природокористування",374,1118,1492,171,261,432,328,-12,19,24,19,19
"Центральноукраїнський національний технічний університет",208,1256,1464,147,476,623,164,66,24,27,24,25
"""Класичний приватний університет""",144,1315,1459,96,252,348,422,4,26,32,22,22
"Київський університет ім. Б. Грінченка",941,515,1456,1051,425,1476,21,1,19,21,18,19
"Вінницький національний технічний університет",190,1262,1452,132,546,678,131,16,19,23,20,19
"Державний вищий навчальний заклад ""Національний лісотехнічний університет України""",185,1243,1428,49,176,225,606,22,18,25,19,19
"Дніпровський національний університет ім. О. Гончара",757,667,1424,643,422,1065,58,-17,19,22,19,20
"Тернопільський національний технічний університет ім. І. Пулюя",163,1259,1422,128,495,623,154,11,19,25,19,19
"Дніпровський державний аграрно-економічний університет",333,1082,1415,279,299,578,262,-25,20,27,18,19
"Харківський національний автомобільно-дорожній університет",125,1287,1412,109,447,556,188,-22,23,28,19,22
"Київський національний університет технологій та дизайну",629,763,1392,533,462,995,65,-6,20,23,18,19
"Національний університет кораблебудування ім. адмірала Макарова",165,1222,1387,202,589,791,107,6,26,27,20,22
"Університет митної справи та фінансів",642,689,1331,494,454,948,52,-11,18,21,18,19
"Харківський національний університет радіоелектроніки",92,1215,1307,271,1223,1494,-1,17,21,27,18,19
"Національний педагогічний університет ім. М. Драгоманова",687,587,1274,892,391,1283,50,-12,20,27,19,20
"Національний транспортний університет",203,1062,1265,269,660,929,61,-21,18,21,18,19
"Одеський національний університет ім. І. І. Мечникова",785,463,1248,703,371,1074,25,8,19,23,19,19
"Національний медичний університет ім. О. Богомольця",877,359,1236,863,545,1408,-34,44,19,20,18,19
"Київський національний університет будівництва і архітектури",422,771,1193,437,492,929,57,-2,19,23,18,19
"Заклад вищої освіти ""Університет Короля Данила""",254,924,1178,138,228,366,305,19,18,28,18,22
"Білоцерківський національний аграрний університет",295,869,1164,162,307,469,183,-43,19,23,18,21
"Вінницький національний аграрний університет",179,978,1157,212,388,600,152,-31,18,22,18,18
"Уманський державний педагогічний університет ім. П. Тичини",438,714,1152,286,283,569,152,-14,22,25,20,23
"Черкаський національний університет ім. Б. Хмельницького",525,620,1145,452,355,807,75,-7,21,24,19,19
"Черкаський державний технологічний університет",206,931,1137,163,275,438,239,-12,20,25,20,21
"Львівський національний університет ветеринарної медицини та біотехнологій ім. С. З. Гжицького",220,912,1132,226,216,442,322,-7,20,27,19,19
"Сумський державний університет",278,847,1125,467,534,1001,59,-2,20,28,19,20
"Українська інженерно-педагогічна академія",197,919,1116,215,290,505,217,12,24,30,20,20
"Харківський національний економічний університет ім. Семена Кузнеця",336,771,1107,904,805,1709,-4,7,21,28,18,20
"Національний університет ""Чернігівська політехніка""",264,828,1092,331,415,746,100,-23,20,26,20,20
"Національний університет ""Одеська політехніка""",203,877,1080,270,570,840,54,0,19,24,18,19
"Одеський національний технологічний університет",265,807,1072,218,261,479,209,-25,19,26,19,19
"Поліський національний університет",242,805,1047,175,321,496,151,-23,19,23,20,20
"Національний юридичний університет ім. Ярослава Мудрого",448,598,1046,832,656,1488,-9,15,19,23,18,19
"Одеський національний морський університет",339,700,1039,458,647,1105,8,-12,19,22,18,20
"Український державний університет залізничного транспорту",80,957,1037,63,102,165,838,-42,22,31,18,19
"Вінницький державний педагогічний університет ім. М. Коцюбинського",572,463,1035,441,189,630,145,-28,20,24,19,19
"Заклад вищої освіти «Подільський державний університет»",75,959,1034,71,161,232,496,-25,22,27,23,21
"Полтавський національний педагогічний університет ім. В. Короленка",449,556,1005,308,142,450,292,-50,22,26,21,22
"Тернопільський національний педагогічний університет ім. В. Гнатюка",394,611,1005,383,150,533,307,-1,19,27,19,20
"Придніпровська державна академія будівництва та архітектури",187,810,997,72,152,224,433,-7,20,28,19,20
"Уманський національний університет садівництва",174,819,993,159,238,397,244,-9,21,28,21,22
"""Міжнародний економіко-гуманітарний університет ім. акад. С. Дем'янчука""",170,818,988,189,157,346,421,-29,21,28,18,20
"Вищий навчальний заклад ""Університет економіки та права ""КРОК""",293,692,985,354,541,895,28,7,17,23,18,19
"Заклад вищої освіти «Відкритий міжнародний університет розвитку людини «Україна»",137,846,983,175,432,607,96,10,23,27,21,22
"Харківський національний університет міського господарства ім. О. Бекетова",244,730,974,537,466,1003,57,-9,21,28,18,21
"Національний університет фізичного виховання і спорту України",273,683,956,230,538,768,27,-23,23,21,21,19
"Чернівецький торговельно-економічний інститут Державного торговельно-економічного університету",85,864,949,47,70,117,1134,-18,21,32,18,20
"Вінницький торговельно-економічний інститут Державного торговельно-економічного університету",386,554,940,340,249,589,122,-1,18,23,18,19
"Університет Григорія Сковороди в Переяславі",213,709,922,146,291,437,144,11,25,27,23,23
"Українська академія друкарства",102,794,896,83,93,176,754,-4,19,28,17,19
"""Луганський національний університет ім. Т. Шевченка""",311,582,893,151,201,352,190,-12,27,29,24,25
"Львівський торговельно-економічний університет",315,566,881,294,377,671,50,36,18,24,18,18
"Національна академія внутрішніх справ",576,291,867,425,234,659,24,24,18,19,18,18
"Державний податковий університет",224,626,850,385,298,683,110,-5,18,26,18,18
"Національний аерокосмічний університет ім. М. Є. Жуковського ""Харківський авіаційний інститут""",80,741,821,195,467,662,59,26,21,29,18,20
"Дрогобицький державний педагогічний університет ім. І. Франка",295,524,819,203,92,295,470,-33,23,27,22,20
"Вищий навчальний заклад Укоопспілки ""Полтавський університет економіки і торгівлі""",276,537,813,263,443,706,21,6,19,23,19,21
"Кременчуцький національний університет ім. М. Остроградського",218,579,797,137,196,333,195,-35,22,23,20,21
"Мукачівський державний університет",322,471,793,277,80,357,489,-16,22,28,19,19
"Заклад вищої освіти “Український католицький університет”",456,336,792,466,300,766,12,9,21,24,21,22
"«Південноукраїнський національний педагогічний університет ім. К. Ушинського»",548,241,789,497,207,704,16,-3,22,25,19,21
"Сумський державний педагогічний університет ім. А.С. Макаренка",261,519,780,212,152,364,241,-17,25,28,21,22
"Івано-Франківський національний медичний університет",475,285,760,464,421,885,-32,38,18,19,18,19
"Національний університет ""Києво-Могилянська академія""",422,334,756,553,348,901,-4,-4,20,23,20,22
"Національний університет ""Чернігівський колегіум"" ім. Т.Г. Шевченка",212,513,725,128,79,207,549,-38,23,28,20,19
"Відокремлений підрозділ Національного університету біоресурсів і природокористування України ""Бережанський агротехнічний інститут""",35,684,719,18,71,89,863,-47,23,27,22,24
"Східноукраїнський національний університет ім. В. Даля",114,592,706,72,113,185,424,-38,28,29,20,22
"Тернопiльський національний медичний університет ім. I. Горбачевського",402,299,701,480,471,951,-37,71,19,20,19,20
"Житомирський державний університет ім. І. Франка",448,248,696,327,113,440,119,13,22,24,20,21
"Національний університет харчових технологій",226,470,696,386,366,752,28,-9,18,24,17,18
"Львівський державний університет безпеки життєдіяльності",297,397,694,243,312,555,27,33,18,20,18,18
"Дніпровський державний технічний університет",97,594,691,31,95,126,525,-10,24,28,21,25
"Дніпропетровський державний університет внутрішніх справ",361,328,689,326,203,529,62,-14,18,20,18,19
"Харківський національний педагогічний університет ім. Г. Сковороди",292,391,683,589,183,772,114,-18,23,30,21,23
"Державний університет інфраструктури та технологій",77,603,680,69,313,382,93,-4,19,24,18,22
"Львівський державний університет внутрішніх справ",416,260,676,412,199,611,31,8,18,22,18,18
"Вінницький національний медичний університет ім. М. Пирогова",449,209,658,399,415,814,-50,52,18,19,19,19
"Одеський державний аграрний університет",167,479,646,175,149,324,221,-23,20,31,20,21
"Заклад вищої освіти ""Міжнародний науково-технічний університет ім. акад. Ю. Бугая""",82,561,643,87,194,281,189,-6,21,27,20,21
"Вищий навчальний заклад ""Університет ім. А. Нобеля""",329,313,642,412,269,681,16,-35,20,24,19,20
"Донецький національний університет ім. В. Стуса",298,337,635,285,213,498,58,-15,18,22,18,19
"Таврійський державний агротехнологічний університет ім. Д. Моторного",128,507,635,135,208,343,144,-22,21,28,19,21
"Національний університет ""Острозька академія""",378,254,632,260,164,424,55,-14,18,20,18,19
"Запорізький державний медичний університет",411,216,627,650,538,1188,-60,82,20,21,19,20
"Харківський національний медичний університет",303,309,612,601,686,1287,-55,17,21,21,19,19
"Полтавський державний медичний університет",378,220,598,317,250,567,-12,0,18,19,18,19
"Київський національний лінгвістичний університет",467,126,593,889,211,1100,-40,13,18,20,18,19
"Львівський державний університет фізичної культури ім. І. Боберського",139,443,582,103,208,311,113,-9,20,22,18,18
"Центральноукраїнський державний університет ім. В. Винниченка",268,302,570,165,129,294,134,-35,20,22,18,20
"Криворізький національний університет",115,446,561,71,161,232,177,-39,19,24,19,20
"""Київський медичний університет""",368,177,545,333,348,681,-49,44,20,19,20,21
"Буковинський державний медичний університет",386,158,544,526,420,946,-62,18,18,20,18,19
"Державний вищий навчальний заклад ""Український державний хіміко-технологічний університет""",137,399,536,103,109,212,266,-8,19,28,18,20
" ""Київський міжнародний університет""",217,318,535,285,260,545,22,-2,20,24,21,21
"Кам'янець-Подільський національний університет ім. І. Огієнка",197,333,530,182,148,330,125,-23,20,24,19,19
"Одеська державна академія будівництва та архітектури",160,351,511,154,173,327,103,-16,23,30,19,21
"Львівський національний медичний університет ім. Данила Галицького",377,128,505,362,266,628,-52,2,18,18,18,19
"Рівненський державний гуманітарний університет",201,295,496,203,99,302,198,-14,20,26,18,18
"""Закарпатський угорський інститут ім. Ференца Ракоці ІІ""",251,218,469,226,85,311,156,-3,19,25,18,17
"Миколаївський національний аграрний університет",121,333,454,142,175,317,90,-44,19,23,18,18
"Харківський національний університет внутрішніх справ",210,241,451,296,393,689,-39,64,18,23,18,18
"""Інститут інноваційної освіти Київського національного університету будівництва і архітектури""",8,441,449,2,100,102,341,69,21,26,24,21
"Чорноморський національний університет ім. П. Могили",199,236,435,386,361,747,-35,6,20,22,19,19
"Хмельницький університет управління та права ім. Л. Юзькова",179,252,431,137,113,250,123,-3,18,24,18,18
"Національний університет ""Одеська морська академія""",54,367,421,74,366,440,0,-7,18,20,18,20
"Глухівський національний педагогічний університет ім. О. Довженка",163,251,414,41,20,61,1155,-33,28,31,24,26
"Київський університет інтелектуальної власності та права Національного університету ""Одеська юридична академія""",174,236,410,95,89,184,165,0,18,21,18,19
"Херсонський державний аграрно-економічний університет",139,269,408,200,236,436,14,-3,24,29,20,22
"Херсонський державний університет",218,174,392,319,152,471,14,-21,22,25,19,19
"Київський національний університет культури і мистецтв",258,130,388,276,108,384,20,-10,18,19,18,18
"Одеський національний економічний університет",205,180,385,296,173,469,4,-12,18,24,18,18
"Державний університет економіки і технологій",149,233,382,130,233,363,0,124,18,22,18,18
"Одеський державний університет внутрішніх справ",242,136,378,149,110,259,24,96,18,20,18,18
"Фаховий коледж ""Освіта"" закладу вищої освіти ""Відкритий міжнародний університет розвитку людини ""Україна""",136,237,373,180,352,532,-33,-7,16,21,17,18
"Таврійський національний університет ім. В.Вернадського",128,243,371,138,142,280,71,15,20,27,19,21
"Академія праці, соціальних відносин і туризму",43,318,361,44,48,92,562,-2,20,32,18,20
"Фаховий коледж Міжнародного гуманітарного університету",252,109,361,364,131,495,-17,25,16,16,16,16
"""Академія рекреаційних технологій і права""",57,303,360,54,114,168,166,12,26,30,26,24
"Фаховий коледж Закладу вищої освіти ""Університет Короля Данила""",219,139,358,242,170,412,-18,70,15,16,16,16
"Одеський національний медичний університет",234,112,346,253,218,471,-49,-6,20,19,19,20
"""Фаховий коледж Київського міжнародного університету""",243,101,344,317,222,539,-55,43,16,16,16,17
"Криворізький державний педагогічний університет",209,129,338,189,56,245,130,-33,22,24,19,20
"Відокремлений підрозділ ""Дніпровський факультет менеджменту і бізнесу Київського університету культури""",98,232,330,54,38,92,511,-38,18,27,18,20
"""Буковинський університет""",25,301,326,17,64,81,370,-3,20,28,21,19
"Національна академія керівних кадрів культури і мистецтв",186,133,319,161,74,235,80,6,20,26,20,21
"Державний університет інтелектуальних технологій і зв'язку",42,275,317,52,207,259,33,0,18,22,18,19
"Комунальний заклад ""Кам'янський фаховий медичний коледж"" Дніпропетровської обласної ради""",235,72,307,138,54,192,33,12,24,20,19,17
"Новомосковський фаховий кооперативний коледж економіки та права ім.С.Литвиненка",186,120,306,146,78,224,54,18,16,18,16,16
"""Івано-Франківський фаховий коледж Львівського національного університету природокористування""",39,266,305,42,77,119,245,22,17,29,16,19
"Чернівецький кооперативний фаховий коледж економіки і права",124,181,305,153,101,254,79,1,16,24,16,16
"Дніпровський державний медичний університет",204,97,301,399,477,876,-80,30,20,20,20,20
"Мелітопольський державний педагогічний університет ім. Б. Хмельницького",171,127,298,276,145,421,-12,-3,27,29,23,22
"Відокремлений підрозділ Національного університету біоресурсів і природокористування України ""Ніжинський агротехнічний інститут""",35,258,293,13,54,67,378,-34,22,25,21,23
"Комунальний заклад вищої освіти «Хортицька національна навчально-реабілітаційна академія» Запорізької обласної ради",164,118,282,184,31,215,281,55,26,30,27,21
"""Фаховий коледж мистецтв та дизайну Київського національного університету технологій та дизайну""",225,46,271,335,57,392,-19,19,16,16,16,16
"Національна академія Служби безпеки України",75,188,263,38,105,143,79,156,19,20,18,19
"Львівська національна академія мистецтв",211,46,257,153,35,188,31,0,19,22,19,21
"""Одеський технічний фаховий коледж Одеського національного технологічного університету""",73,180,253,96,200,296,-10,135,16,20,18,18
"Херсонська державна морська академія",0,247,247,4,343,347,-28,15,0,23,18,20
"""Відкритий міжнародний університет розвитку людини ""Україна"" Вінницький соціально-економічний інститут",64,182,246,50,32,82,469,-30,28,29,28,26
"Комунальний заклад ""Одеський обласний базовий медичний фаховий коледж""",186,58,244,231,67,298,-13,6,19,17,17,16
"""Хмельницький політехнічний фаховий коледж Національного університету ""Львівська політехніка""",46,192,238,33,196,229,-2,18,15,16,15,16
"Бердянський державний педагогічний університет",93,144,237,209,155,364,-7,-12,24,27,20,20
"""Фінансово-правовий коледж""",129,106,235,119,129,248,-18,2,16,17,16,17
"«Технічний фаховий коледж Луцького національного технічного університету»",65,165,230,56,179,235,-8,180,16,18,16,16
"Вінницький ННІ економіки Західноукраїнського національного університету",33,196,229,30,61,91,221,-13,19,28,18,19
"Київський національний університет театру, кіно і телебачення ім. І. Карпенка-Карого",138,90,228,115,82,197,10,2,20,23,19,20
"Харківська державна академія фізичної культури",49,178,227,44,93,137,91,-38,23,25,21,21
"Рівненський кооперативний економіко-правовий фаховий коледж",134,92,226,179,83,262,11,0,16,19,17,16
"Комунальний заклад вищої освіти Львівської обласної ради ""Львівська медична академія ім. Андрея Крупинського""",154,71,225,188,48,236,48,37,19,24,17,17
"Харківський національний університет будівництва та архітектури",24,201,225,76,141,217,43,-20,22,31,20,23
" ""Східноєвропейський університет ім. Р. Аблязова""",43,181,224,23,37,60,389,-35,19,29,18,28
"Харківська державна академія дизайну і мистецтв",141,81,222,173,73,246,11,11,20,26,19,22
"«Економіко-правничий фаховий коледж Запорізького національного університету»",148,73,221,183,116,299,-37,32,16,16,16,16
"Ніжинський державний університет ім. М. Гоголя",89,132,221,78,57,135,132,-20,20,26,19,21
"Київський фаховий коледж туризму та готельного господарства",106,114,220,152,149,301,-23,6,16,17,16,16
"Національний фармацевтичний університет",122,98,220,274,169,443,-42,-6,22,32,19,20
"Комунальний заклад вищої освіти ""Вінницька академія безперервної освіти""",72,146,218,55,15,70,873,50,35,33,40,39
"Львівський кооперативний фаховий коледж економіки і права",128,90,218,178,134,312,-33,23,16,22,16,16
"Одеський морехідний фаховий коледж морського та рибопромислового флоту ім. О. Соляника",0,218,218,0,362,362,-40,26,0,16,0,16
"Хмельницький кооперативний фаховий коледж Хмельницького кооперативного торговельно-економічного інституту",135,83,218,186,128,314,-35,29,15,16,16,16
"""Волинський фаховий коледж Національного університету харчових технологій""",48,169,217,73,85,158,99,13,16,22,16,16
"Ізмаїльський державний гуманітарний університет",129,88,217,107,43,150,105,-10,21,26,20,24
"Вінницький медичний фаховий коледж ім. акад. Д. Заболотного",174,42,216,169,30,199,40,-23,19,17,17,17
"Полтавський фаховий кооперативний коледж",136,77,213,151,76,227,1,15,16,21,16,17
"Хмельницький кооперативний торговельно-економічний інститут",83,128,211,66,91,157,41,14,19,20,20,20
"""Київський кооперативний інститут бізнесу і права""",58,152,210,36,53,89,187,-13,20,24,19,20
"""Мукачівський фаховий коледж Національного університету біоресурсів і природокористування України""",67,141,208,97,82,179,72,134,16,22,16,16
"""Рівненський фаховий коледж Національного університету біоресурсів і природокористування України""",73,135,208,82,103,185,31,27,16,19,16,17
"Херсонський ННІ Національного університету кораблебудування ім. адмірала Макарова",17,190,207,11,153,164,24,30,27,29,34,29
"Заклад вищої освіти ""Львівський університет бізнесу та права""",16,190,206,19,48,67,296,100,22,31,20,23
"""Бережанський фаховий коледж Національного університету біоресурсів і природокористування України""",11,194,205,16,83,99,134,-20,23,24,24,22
"Черкаський інститут пожежної безпеки ім. Героїв Чорнобиля Національного університету цивільного захисту України",74,131,205,48,64,112,105,16,18,19,18,18
"Черкаська медична академія",159,45,204,200,55,255,-18,8,19,20,18,19
"Полтавський юридичний інститут Національного юридичного університету ім. Ярослава Мудрого",92,108,200,53,53,106,104,-25,18,20,18,19
"Вищий навчальний приватний заклад ""Дніпровський гуманітарний університет""",94,105,199,50,45,95,133,-21,19,25,18,20
"Галицький фаховий коледж ім. В. Чорновола",107,91,198,92,39,131,133,-11,17,18,16,16
"Національний університет цивільного захисту України",55,142,197,104,170,274,-16,-9,20,26,17,18
"Фаховий коледж Закладу вищої освіти «Міжнародний науково-технічний університет ім. акад. Ю. Бугая»",80,114,194,46,75,121,52,88,16,15,16,16
"Малинський фаховий коледж",10,177,187,6,68,74,160,100,17,27,17,21
"ПрАТ """"Запорізький інститут економіки та інформаційних технологій""",30,157,187,38,78,116,101,24,20,25,18,20
"""Івано-Франківський фаховий коледж фізичного виховання Національного університету фізичного виховання і спорту України""",27,159,186,26,109,135,46,28,18,20,17,18
"Житомирський агротехнічний фаховий коледж",9,177,186,55,214,269,-17,67,15,20,17,18
"“Київський фаховий коледж комп’ютерних технологій та економіки Національного авіаційного університету”",25,159,184,10,146,156,9,82,16,16,15,15
"Національна академія статистики, обліку та аудиту",47,134,181,50,70,120,91,-19,18,23,19,20
"«Фаховий коледж економіки, права та інформаційних технологій Західноукраїнського національного університету»",82,96,178,126,150,276,-36,55,16,23,16,17
"КОМУНАЛЬНИЙ ЗАКЛАД ""ДНІПРОВСЬКИЙ БАЗОВИЙ ФАХОВИЙ МЕДИЧНИЙ КОЛЕДЖ"" ДНІПРОПЕТРОВСЬКОЇ ОБЛАСНОЇ РАДИ""",145,32,177,167,27,194,19,-13,22,18,19,17
"вищої освіти ""Університет менеджменту освіти""",48,126,174,35,26,61,385,-4,21,31,18,20
"Тернопільський кооперативний фаховий коледж",119,55,174,147,57,204,-4,68,16,21,16,16
"""Відкритий міжнародний університет розвитку людини ""Україна"" Луцький інститут розвитку людини",33,140,173,57,37,94,278,-35,23,29,23,25
"""Маловисторопський фаховий коледж ім. П. Рибалка Сумського національного аграрного університету""",18,151,169,34,88,122,72,87,27,31,28,25
"""Технологічний фаховий коледж Національного університету ""Львівська політехніка""",79,90,169,118,98,216,-8,88,16,19,16,16
"""Морехідний фаховий коледж ім. О. Маринеска Національного університету ""Одеська морська академія""",16,152,168,3,121,124,26,8,15,17,17,18
"Чернівецький транспортний фаховий коледж",2,165,167,4,49,53,237,63,33,27,21,17
"Фаховий коледж Київського університету інтелектуальної власності та права Національного університету ""Одеська юридична академія""",100,65,165,137,94,231,-31,0,16,16,16,16
"""Фаховий коледж морського транспорту Національного університету ""Одеська морська академія""",4,160,164,2,188,190,-15,3,15,16,15,15
"Київський фаховий коледж зв'язку",20,144,164,30,185,215,-22,0,17,18,16,17
"Херсонський національний технічний університет",54,110,164,138,192,330,-43,-10,22,22,20,19
"""Техніко-економічний фаховий коледж Національного університету ""Львівська політехніка""",54,109,163,55,52,107,110,18,16,27,16,16
"""Відкритий міжнародний університет розвитку людини ""Україна"" Миколаївський інститут розвитку людини",27,133,160,58,63,121,111,-2,29,28,32,24
"Луцький фаховий коледж рекреаційних технологій і права",23,137,160,34,51,85,169,59,18,30,16,17
"Житомирський кооперативний фаховий коледж бізнесу і права",92,67,159,123,85,208,-21,39,16,16,16,16
"Фаховий коледж Приватного вищого навчального закладу ""Буковинський університет""",11,148,159,24,37,61,300,3,15,30,16,16
"Приватна установа ""Університет ""Київська школа економіки""",69,89,158,81,114,195,-22,70,21,24,22,22
"«Рівненський автотранспортний фаховий коледж Національного університету водного господарства та природокористування»",8,149,157,8,135,143,10,42,15,16,16,16
"Київський університет права Національної академії наук України",51,106,157,46,56,102,89,-2,18,25,19,21
"Національна музична академія України ім. П. Чайковського",78,79,157,93,113,206,-30,38,26,26,23,24
"""Тернопільський фаховий коледж Тернопільського національного технічного університету ім. І. Пулюя""",11,145,156,24,157,181,-8,10,16,18,17,17
"Харківська державна академія культури",63,92,155,105,54,159,70,-13,22,28,18,20
"Харківський гуманітарний університет ""Народна українська академія""",51,103,154,74,16,90,544,-56,26,33,21,21
"Черкаський державний бізнес-коледж",37,117,154,64,121,185,-3,73,17,22,16,17
"Вищий приватний навчальний заклад ""Львівський медичний університет""",91,62,153,34,34,68,82,21,23,22,22,19
"""Немішаївський фаховий коледж Національного університету біоресурсів і природокористування України """,35,117,152,55,96,151,22,48,23,23,21,19
"Економіко-правовий фаховий коледж Київського кооперативного інституту бізнесу і права",77,75,152,108,117,225,-36,54,16,17,16,16
"Київська державна академія декоративно-прикладного мистецтва і дизайну ім. М. Бойчука",120,32,152,144,17,161,88,-48,20,24,18,20
"Комунальний заклад вищої освіти ""Волинський медичний інститут"" Волинської обласної ради",140,12,152,64,3,67,300,-25,20,19,17,15
"""Фаховий коледж економіки і технологій Національного університету ""Чернігівська політехніка""",89,62,151,132,62,194,0,32,16,23,16,17
"Одеський державний екологічний університет",13,138,151,10,50,60,176,-18,20,23,19,20
"Коледж Приватного закладу вищої освіти ""Міжнародний класичний університет ім. П. Орлика""",87,62,149,131,77,208,-19,103,19,20,17,16
"""Охтирський фаховий коледж Сумського національного аграрного університету""",7,141,148,20,67,87,110,235,17,27,18,17
"Маріупольський державний університет",49,99,148,170,129,299,-23,-18,23,27,19,21
"Національна академія образотворчого мистецтва і архітектури",111,36,147,95,23,118,57,-8,20,26,19,19
"""Відкритий міжнародний університет розвитку людини ""Україна"" Хмельницький інститут соціальних технологій",44,101,145,31,49,80,106,48,26,25,28,21
"""Фаховий коледж інженерії, управління та землевпорядкування Національного авіаційного університету""",52,92,144,134,304,438,-70,54,16,16,16,16
"Вищий навчальний заклад ""Київський університет ринкових відносин"" у формі ТзОВ",15,129,144,17,46,63,180,28,20,28,20,21
"Миколаївський національний університет ім. В. Сухомлинського",58,86,144,106,109,215,-21,14,23,24,21,23
"""Харківський торговельно-економічний фаховий коледж Державного торговельно-економічного університету""",25,117,142,50,43,93,172,-25,21,31,19,19
"Харківський кооперативний торгово-економічний фаховий коледж",86,56,142,183,114,297,-51,34,15,19,16,16
"""Природничо-гуманітарний фаховий коледж Державного вищого навчального закладу ""Ужгородський національний університет""",56,85,141,64,119,183,-29,78,15,17,15,16
"Сумський фаховий коледж економіки і торгівлі",26,115,141,84,54,138,113,50,18,31,19,19
"Фаховий коледж економіки і права Вінницького кооперативного інституту",74,67,141,89,54,143,24,12,16,24,16,17
"Придніпровська державна академія фізичної культури і спорту",41,98,139,13,53,66,85,-5,22,21,22,18
"""Коломийський політехнічний фаховий коледж Національного університету ""Львівська політехніка""",24,112,136,19,55,74,104,77,16,24,16,16
"«Класичний фаховий коледж Сумського державного університету»",14,122,136,20,39,59,213,255,28,30,24,22
"“Фаховий коледж технологій, бізнесу та права Волинського національного університету ім. Лесі Українки”",61,72,133,104,87,191,-17,58,16,19,16,17
"«Фаховий коледж Чернівецького національного університету ім. Ю. Федьковича»",62,71,133,62,90,152,-21,64,15,17,16,16
"Мукачівський кооперативний фаховий коледж бізнесу",67,66,133,109,63,172,5,-6,15,21,15,16
"Донецький державний університет внутрішніх справ",74,58,132,98,62,160,-6,19,18,22,17,18
"Фаховий коледж Класичного приватного університету",67,65,132,100,134,234,-51,11,16,21,16,16
"""Первомайський фаховий коледж Національного університету кораблебудування ім. адмірала Макарова""",43,85,128,63,88,151,-3,54,16,16,17,17
"""Фаховий коледж інформаційних технологій та землевпорядкування Національного авіаційного університету""",21,107,128,47,155,202,-31,82,17,18,17,17
"""Луганський державний медичний університет""",87,40,127,73,73,146,-45,217,21,19,22,21
"Вінницький технічний фаховий коледж",16,111,127,18,140,158,-21,16,15,16,16,16
"Заклад фахової передвищої освіти «Київський міський медичний фаховий коледж»",74,52,126,79,56,135,-7,8,19,18,18,16
"Одеська національна музична академія ім. А.В. Нежданової",64,61,125,82,70,152,-13,-15,25,25,23,25
"ПрАТ «Українсько-Польський вищий навчальний заклад ""Центрально-Європейський університет»",29,96,125,33,65,98,48,-32,27,29,25,26
"Сумська філія Харківського національного університету внутрішніх справ",57,68,125,58,45,103,51,41,18,28,18,19
"Харківський автомобільно-дорожній фаховий коледж",17,108,125,61,89,150,21,35,17,29,16,17
"""Одеський автомобільно-дорожній фаховий коледж Національного університету ""Одеська політехніка""",12,112,124,21,161,182,-30,0,19,21,18,17
"""Фаховий коледж Кременчуцького національного університету ім. М. Остроградського""",34,89,123,51,80,131,11,-7,16,19,16,17
"Донбаська державна машинобудівна академія",31,92,123,16,39,55,136,-33,25,25,20,19
"""Полтавський фаховий коледж Національного юридичного університету ім. Ярослава Мудрого""",85,37,122,99,44,143,-16,2,16,17,16,16
"""Фаховий коледж нафтогазових технологій, інженерії та інфраструктури сервісу Одеського національного технологічного університету""",63,59,122,140,104,244,-43,27,16,20,17,17
"Приватний фаховий навчальний заклад «Медичний коледж»",89,33,122,127,28,155,18,-22,17,17,17,17
"Житомирський базовий фармацевтичний фаховий коледж Житомирської обласної ради",117,4,121,141,20,161,-80,67,16,15,16,16
"""Виноградівський фаховий коледж Мукачівського державного університету""",22,98,120,32,44,76,123,214,16,27,16,16
"""Стрийський фаховий коледж Львівського національного університету природокористування""",37,83,120,23,51,74,63,-4,16,22,15,16
"Білгород-Дністровський економіко-правовий фаховий коледж Вищого навчального закладу Укоопспілки ""Полтавський університет економіки і торгівлі""",77,43,120,75,31,106,39,-16,16,18,16,17
"""Український гуманітарний інститут""",50,69,119,52,33,85,109,-20,18,24,18,20
" ""Арт академія сучасного мистецтва ім. С. Далі""",65,53,118,85,36,121,47,-14,21,26,18,23
"""Фаховий коледж транспорту та комп`ютерних технологій Національного університету ""Чернігівська політехніка""",5,112,117,8,173,181,-35,38,15,16,15,16
"«Вишнянський фаховий коледж Львівського національного університету природокористування»",12,105,117,38,43,81,144,-23,22,28,16,17
"Львівська національна музична академія ім. М.В.Лисенка",60,56,116,44,53,97,6,23,22,24,22,23
"""Криворізький фаховий коледж Національного авіаційного університету""",22,93,115,27,167,194,-44,106,19,19,17,18
"Академія Державної пенітенціарної служби",68,46,114,67,37,104,24,-23,18,19,17,18
"Медичний фаховий коледж Міжнародного гуманітарного університету",97,16,113,171,24,195,-33,9,16,19,17,16
"«Уманський фаховий коледж технологій та бізнесу Уманського національного університету садівництва»",24,88,112,24,83,107,6,60,17,18,16,16
"Хмельницький базовий медичний фаховий коледж",101,10,111,104,11,115,-9,0,19,15,16,15
"Київський фаховий коледж прикладних наук",85,24,109,114,36,150,-33,100,16,17,17,17
"Чернівецький медичний фаховий коледж",79,28,107,123,23,146,22,77,20,21,19,18
"Одеський фаховий коледж транспортних технологій",20,85,105,51,76,127,12,73,19,23,18,18
"""Інститут екології економіки і права""",10,94,104,33,51,84,84,6,23,29,24,24
"Державний вищий навчальний заклад ""Приазовський державний технічний університет""",29,75,104,90,126,216,-40,-46,28,29,19,19
"Луцький кооперативний фаховий коледж Львівського торговельно-економічного університету",58,46,104,78,35,113,31,40,16,21,16,17
"Структурний підрозділ ""Фаховий коледж економіки та інформаційних технологій"" ПрАТ """"Запорізький інститут економіки та інформаційних технологій""",35,69,104,68,98,166,-30,227,16,16,16,16
"Первомайський ННІ Національного університету кораблебудування ім. адмірала Макарова",18,85,103,19,38,57,124,-3,21,23,23,22
"Чернівецький фаховий коледж технологій та дизайну",34,69,103,53,9,62,667,50,17,33,18,23
"Вінницький кооперативний інститут",11,91,102,23,35,58,160,-40,18,23,22,20
"Комунальний заклад фахової передвищої освіти ""Івано-Франківський медичний фаховий коледж"" Івано-Франківської обласної ради",92,9,101,107,16,123,-44,7,16,16,17,16
"фаховий коледж Житомирського медичного інституту Житомирської обласної ради",67,34,101,79,40,119,-15,33,18,17,17,17
"Черкаський кооперативний економіко-правовий фаховий коледж Вищого навчального закладу Укоопспілки ""Полтавський університет економіки і торгівлі""",49,52,101,83,48,131,8,66,16,21,16,16
